TKCAD: AUFLÖSUNG / LIQUIDATION
TKCBD: BANKRUPTCY / KONKURSVERFAHREN
TKCCD: CLASS ACTION
TKCDD: DOMIZILÄNDERUNG GESELLSCHAFT
TKCED: COUPONADMINISTRATION
TKCFD: GESELLSCHAFTSREORGANISATION
TKCGD: GLEICHSTELLUNG
TKCID: ERTRAGS-/ZINSPLAN
TKCKD: KAUF / UMTAUSCH / RÜCKKAUF
TKCLD: RÜCKZAHLUNGSPLAN
TKCMD: AMORTISATIONSPLAN
TKCND: NAMENSÄNDERUNG
TKCRD: KAPITALVERÄNDERUNG
TKCSD: ÄNDERUNG ISIN/NKN UND ÜBRIGE EREIGNISSE
TKCWD: TITELUMTAUSCH / -UMWANDLUNG
TKCZD: ZINSSATZÄNDERUNG
TKDAD: VP STAMMDATEN
TKDBD: INDEX FACTORS BY COUNTRY
TKDCD: DOUBLE TAX AGREEMENT
TKDED: LIEFERBESTIMMUNGEN
TKDFD: FIXIERUNGSSTELLEN
TKDGD: GARANTIE / ZUSICHERUNG
TKDID: INSTITUTIONSROLLEN
TKDKD: INSTRUMENTEN-RESTRIKTIONEN
TKDTD: INSTRUMENTEN-RATING
TKEMD: EMISSIONSBEDINGUNGEN
TKERD: FONDS-SELBSTDEKLARATION
TKEUD: EU-ZINSBESTEUERUNG
TKFAD: INSTRUMENTEN-ADMINISTRATION
TKFDD: INDEX-ZUSATZDATEN
TKFFD: INSTRUMENTEN-RATING
TKFGD: INSTRUMENT-ABHAENGIGKEIT (DOWN)
TKFHD: INSTRUMENT-ABHÄNGIGKEIT (UP)
TKFID: INDEX- / FONDS-ZUSAMMENSETZUNG
TKFQD: INSTRUMENTEN-ZUSAMMENSETZUNG
TKFSD: TAX AND REPORTING / REGULATION
TKFTD: ANLAGEFONDS / TRUST-STAMMDATEN
TKFUD: INSTRUMENT-STRUKTUR
TKFXD: INDEX-ZUSAMMENSETZUNG
TKFZD: INSTRUMENTEN-ZUSATZDATEN
TKHAD: KURSARTEN
TKHBD: HANDELSBEDINGUNGEN
TKHCD: KURSGRUPPEN
TKHED: PARITAETSKURSE
TKHGD: HANDELSGRUPPEN
TKHMD: ABWICKLUNGSARTEN
TKHPD: HANDELSPLATZ-KALENDER
TKHSD: HANDELSSCHEMA
TKHUD: HANDELSEREIGNISSE
TKHXD: KOTIERUNG/DEKOTIERUNG
TKHZD: ZEITREIHEN-DEFINITION
TKIAD: INSTITUTIONEN-ADMINISTRATION
TKIBD: HANDELSPLATZ-STRUKTUR (TOP DOWN)
TKIFD: INSTITUTIONEN-RATING
TKIGD: VERSAMMLUNG
TKIHD: HANDELSPLATZ-ADMINISTRATION
TKIRD: INSTITUTIONEN-RATING
TKISD: INSTITUTIONEN-STRUKTUR (DOWN)
TKITD: ANLAGEFONDS / TRUST-STAMMDATEN
TKIUD: INSTI - INSTI - ROLLEN
TKIVD: ANLAGEFONDS/TRUST-ZUSAMMENSETZUNG
TKLRD: LÄNDER-ADMINISTRATION
TKLSD: LÄNDER-STRUKTUR
TKLTD: STEUER-GRUPPE/-RÜCKFORDERUNG
TKLUD: REGIONEN
TKMED: METADATEN
TKOPD: OPPOSITIONEN
TKPRD: KURSE UND KENNZAHLEN
TKPSD: STEUERKURSE
TKPYD: JAHRESKURSE UND -KENNZAHLEN
TKRFD: REGIONALDATEN FRANKREICH
TKSAD: INSTRUMENTEN SCHEMA
TKSBD: SPRACHEN
TKSDD: DOMIZIL SCHEMA
TKSED: INSTITUTIONEN SCHEMA
TKSFD: INSTRUMENT-KATEGORIESCHEMA
TKSGD: BRANCHEN-SCHEMA
TKSHD: RATING-SCHEMA
TKSKD: INSTRUMENT KATEGORIE STRUKTUR
TKSLD: BRANCHEN-STRUKTUR
TKSMD: INSTRUMENT-KATEGORIESYMBOL
TKSND: BRANCHEN-SYMBOL
TKSOD: RATING-SYMBOLE
TKSPD: PHYSISCHE EINHEITEN
TKSQD: QUELLE
TKSRD: RESTRIKTIONEN
TKTED: TECHNISCHES DOC FÜR ONLINE-DOCS
TKTMD: SONDERMELDUNGEN SIX TELEKURS
TKVKD: INSTRUMENTEN-KAPITALSTRUKTUR
TKVTD: INSTRUMENTEN-TRANSFORMATION
TKXBD: AMORTISATIONEN
TKXCD: AUSSCHÜTTUNGEN
TKXND: ZAHLUNGSMENGE
TKXOD: BEDINGUNGEN
TKXPD: VORZEITIGE RÜCKZAHLUNG / LAUFZEITÄNDERUNG
TKXRD: RÜCKZAHLUNG / AUSÜBUNG
TKXSD: STEUERN
TKXTD: STEUERERHEBUNG AUF EREIGNISSE FÜR VERTRAGSSTAATEN
TKXUD: UNDERLYING
TKXZD: ZAHLUNGSZUSAMMENSETZUNG
TKYBD: HPS HANDELSPLATZ-INFORMATIONEN
TKYGD: HPS GESELLSCHAFTS-INFORMATIONEN
TKYSD: TOP INSTRUMENT
TKYUD: HPS UNDERLYING-INFORMATIONEN
TKYWD: HPS WERTSCHRIFTEN-INFORMATIONEN
TKZAD: GESELLSCHAFTSEREIGNIS-ÜBERSICHT
TKZCD: SAMMELKLAGE/CLASS ACTION
TKZED: UMSTELLUNG NOMINALWÄHRUNG
TKZKD: ÄNDERUNG KAPITAL UND/ODER TITELZAHL
TKZSD: ÄNDERUNG GESELLSCHAFTSSTAMMDATEN
TKZTD: TRANSFORMATION
TKZVD: VERFAHREN
